1,1,1,1,1,1,1,1,1,1,1,1,1,1,1
1,1,1,1,1,1,1,1,1,1,1,1,1,1,1
1,1,1,1,1,1,1,1,1,1,1,1,1,1,1
1,1,1,1,1,1,,,,1,,,1,1,1
1,1,1,1,1,1,,3,,,,2,1,1,1
1,1,1,1,1,1,,,,1,,,1,1,1
1,1,1,1,1,1,,,,1,1,1,1,1,1
1,1,1,1,1,1,,,,1,1,1,1,1,1
1,1,1,1,1,1,,,,1,1,1,1,1,1
1,1,1,,,1,,,,1,1,1,1,1,1
1,1,1,10,,,,,,1,1,1,1,1,1
1,1,1,,,1,,,,1,1,1,1,1,1
1,1,1,1,1,1,,,,1,1,1,1,1,1
1,1,1,1,1,1,,,,1,1,1,1,1,1
1,1,1,1,1,1,1,,1,1,1,1,1,1,1
1,1,1,1,1,1,,17,,1,1,1,1,1,1
1,1,1,1,1,1,,,,1,1,1,1,1,1
1,1,1,1,1,1,,-1,,1,1,1,1,1,1
1,1,1,1,1,1,1,1,1,1,1,1,1,1,1
1,1,1,1,1,1,1,1,1,1,1,1,1,1,1
1,1,1,1,1,1,1,1,1,1,1,1,1,1,1
